width = 4096
height = 2816

max_provinces = 4361
sea_starts = { 
	1 2 3 4 5 6 7 8 9 10 11 12 13 14 15 16 17 18 19 20 21 22 23
	24 25 26 27 28 29 30 31 32 33 34 35 36 37 38 39 40 41 42 43
	44 45 46 47 48 49 50 51 52 53 54 55 56 57 58 59 60 61 62 63
	64 65 66 67 68 69 70 71 72 73 74 75 76 77 78 79 80 81 82 83
	84 85 86 87 88 89 90 91 92 93 94 95 96 97 98 99
	100 101 102 103 104 105 106 107 108 109 110 111 112 113 114
	115 116 117 118 119 120 121 122 123 124 125 126 127 128 129
	130 131 132 133 134 135 136 137 138 139 140 141 142 143 144
	145 146 147 148 149 150 151 152 153 154 155 156 157 158 159
	160 161 162 163 164 165 166 167 168 169 170 171 172 173 174
	175 176 177 178 179 180 181 182 183 184 185 186 187 188 189
	190 191 192 193 194 195 196 197 198 199 200 201 202 203 204
	205 206 207 208 605 606 607 608 669 674 675 676 790 791 792
	1534 1822 1823 1824 1825 1826 1827 1828 1829 1830 1831 1832
	1833 1834 1835 1836 1837 1838 1839 1840 1841 1842 1843 1844
	1845 1846 1847 1848 1849 1850 1851 1852 1853 1854 1855 1856
	1857 1858 1859 1860 1861 1862 1863 1864 1865 1866 1867 1868
	1869 1870 1871 1872 1873 1874 1875 1876 1877 1878 1879 1880
	1881 1882 1883 1884 1885 1886 1886 1887 1888 1889 1890 1891
	1892 1893 1894 1895 1896 1897 1898 1899 1900 1901 1902 1903
	1904 1905 1906 1907 1908 1909 1910 1911 1912 1913 1914 1915
	1916 1917 1918 1919 1920 1921 1922 1923 1924 1925 1926 1927
	1928 1929 1930 1931 1932 1933 1934 1935 1936 1937 1938 1939
	1940 1941 1942 1943 1944 1945 1946 1947 1948 1949 1950 1951
	1952 1953 1954 1955 1956 1957 1958 1959 1960 1961 1962 1963
	1964 1965 1966 1967 1968 1969 1970 1971 1972 1973 1974 1975
	1976 1977 1978 1979 1980 1981 1982 1983 1984 3661 3662 3663
	3664 3665 3666 3667 3668 3669 3670 3671 3672 3673 3674 3675
	3676 3677 3678 3679 3680 3681 3682 3683 3684 3748 3749 3750
	3685 3686 3687 3688 3689 3690 3691 3692 3693 3694 3695 3696
	3697 3698 3699 3700 3701 3702 3703 3704 3705 3706 3707 3708
	3709 3710 3711 3712 3713 3714 3715 3716 3717 3718 3719 3720
	3721 3722 3723 3724 3725 3726 3727 3728 3729 3730 3731 3732
	3733 3734 3735 3736 3737 3738 3739 3740 3741 3742 3743 3744
	3745 3746 3747 3751 3752 3753 3754 3755 3756 3757 3758 3759
	3760
}

only_used_for_random = {
}

lakes = {
	242 243 521 522 523 524 525 670 671 672 673
	1054 1055 1056 1057 1058 1059 1060 1114 1115 1116 1258 1259 1260 1261 1262 1263
	1364 1365 1366 1367 1433 1434 1435 1516	1985 1986 1987 1988 1989 1990 1991 1992
	1993 1994 1995 1996 1997 1998 1999 2000 2001 2002 2686
}

force_coastal = {
}

definitions = "definition.csv"
provinces = "provinces.bmp"
positions = "positions.txt"
terrain = "terrain.bmp"
rivers = "rivers.bmp"
terrain_definition = "terrain.txt"
heightmap = "heightmap.bmp"
tree_definition = "trees.bmp"
continent = "continent.txt"
adjacencies = "adjacencies.csv"
climate = "climate.txt"
region = "region.txt"
superregion = "superregion.txt"
area = "area.txt"
provincegroup = "provincegroup.txt"
ambient_object = "ambient_object.txt"
seasons = "seasons.txt"
trade_winds = "trade_winds.txt"

# Define which indices in trees.bmp palette which should count as trees for automatic terrain assignment
tree = { 3 4 7 10 }
